00000000000000000000000000000000000000000000000000
00011111100000000000000000000000000000000000000000
00010000100000000000000000000000000010000000000000
00010000100000000000000000000000000010001111111100
00010000111111110000000000000000000010000000000000
00010000000000010000000000000000000010000000000000
00010000100000010000000010111111100000000000000000
00010000100000010000000010100000100010000000000000
00010000100000010000000010101000100010000010000000
00010000000000010011110010001000101111000010000000
00011111111111110000001010001000000000000000000000
00000000000001000000001010001000000010000010000000
00000000000001000000001010001000000010000010000000
00000000000000000111101010001000000010000000000000
00000000000001000000100010001000000000000010000000
00001111110000000000100010001000000000000010000000
00000000000001000000100010001000000000000010000000
00000000000001000000100000001000001110000010000000
00000000000000000000111111111000001110000010000000
00000000000001000000000000000000001110000010000000
00000000000001000000000000000000000000000000000000
00000000100001000000000000000000000000000000000000
00001011100001000000000000000000000000000000000000
00001000000111110010000000000001110111011000000000
00001000000000100011111111000001110111011000000000
00001000000000100010000000000000000000000000000000
00001000000000000010000000000000000000000000000000
00001000000000000000000000000000000000000000000000
00000000000000000000000000000000000000000000000000
00000000000000000000000000000000000000000000000000